d......l
........
...xx...
..xxxx..
..xxxx..
...xx...
........
r......u
