d......l
..m..l..
...xx...
..xxxx..
..xxxx.b
...xx...
........
r......u
