............
.d....l.....
..f......f..
...xxxwxx...
...xd..lx...
...x.m..x...
.r.w..u.x...
...xr..uw...
...xxwxxx...
..f......f..
.....u..bb..
............
